[level]
theme = wood
startpos = 1,0
name = Test Level 1
desc = This is a test level, nothing special about it. You can't even reach the end of the level. Have foon!
map = ....^..................................................
      =..====................................................
      |..................................................C...
      |........^.....R.......................L...............
      |.....=========================================.......|
      |.....................................................|
      |.^.U............................................^....|
      =======================================================