[level]
theme = wood
map = =..====...............
      |.....|...............
      |.....|..^......^.....
      |.....================
      |....................|
      |.^..................|
      ======================