[pack]
name = The Original Test Map
desc = Enter the world of maps made by Chompy.
order = map1,map1

[map1]
theme = forest
startpos = 1,0
name = Test Level 1
desc = This is a test level, nothing special about it. You can't even reach the end of the level. Have foon!
skills = up,up,heli,heli
map = ....^..................................................
      =..====................................................
      |..................................................C...
      |/%......^...R...^.......^.........^........^..........
      |.....=========================================.......|
      |...................................................&\|
      |.^.U............................................^....|
      =======================================================
