[level]
theme = wood
startpos = 1,0
map = ....^.................
      =..====...............
      |.....................
      |........^......^.....
      |.....================
      |....................|
      |.^..................|
      ======================