[pack]
name = Forest Test Map
desc = Enter the world of maps made by Chompy.
order = map1,map1

[map1]
theme = forest
startpos = 4,20
name = Forest 1
desc = Boooooing!
skills = heli
map = .=========================......................
      .|..............................................
      .|..............................................
      .|..........R...................................
      .|..... ===========..====.......................
      ..|.....|.........|..|..........................
      ..|...&\|.........|..|..........................
      ..|.....|.........|..|..........................
      ..|.....|.........|..|======|...................
      ..|/%...|.........|.........|...................
      ..|.....|.........|.......C.|...................
      ..|.....|.........|..|======|...................
      ..|...&\|.........|..|..........................
      ..|.....|.........|..|..........................
      ..|.....|.........|..|..........................
      ..|/%...|.........|..|..........................
      ..|.....|.........|..|..........................
      ..|.....|.........|..|..........................
      ..|...&\|.........|..|..........................
      ..|.....|.........|..|..........................
      ..|.....|.........|..|..........................
      ..|/%...|.........|..|..........................
      ..|.....|.........|..|..........................
      ..|.....|.........|..|..........................
      ..|.....|.........|..|..........................
      ..|..^.U|.........|..|..........................
      ..|=====|.........|..|..........................